国名英文大全
AF - Afghanistan 阿富汗 
AL - Albania 阿尔巴尼亚 
DZ - Algeria 阿尔及利亚 
AS - American Samoa 东萨摩亚 
AD - Andorra 安道尔 
AO - Angola 安哥拉 
Av - Anguilla 安圭拉岛 
AQ - Antarctica 南极洲 
AG - Antigua and Barbuda 安提瓜 巴布达 
AR - Argentina 阿根廷 
AM - Armenia 亚美尼亚 
AA - Aruba 阿鲁巴 
AU - Australia 澳大利亚 
AT - Austria 奥地利 
AZ - Azerbaijan 阿塞拜疆 
BF - Bahamas 巴哈马 
BH - Bahrain 巴林 
BB - Barbados 巴巴多斯 
BD - Bangladesh 孟加拉 
BY - Belarus 白俄罗斯 
BE - Belgium 比利时 
BZ - Belize 伯里兹 
BJ - Benin 贝宁 
BM - Bermuda 百慕大 
BS - Bahamas 巴哈马 
BT - Bhutan 不丹 
BW - Botswana 博茨瓦纳 
BO - Bolivia 玻利维亚 
BA - Bosnia and Herzegovina 波黑 
BV - Bouvet Island 布韦岛 
BR - Brazil 巴西 
IO - British Indian Ocean Territory 英属
BN - Brunei Darussalam 文莱
BG - Bulgaria 保加利亚 
BF - Burkina Faso 布基纳法索 
BI - Burundi 布隆迪 
KH - Cambodia (Internet) 柬埔寨 
CB - Cambodia (CIA World Fact Book) 柬埔寨 
CM - Cameroon 喀麦隆 
CA - Canada 加拿大 
CV - Cape Verde 佛得角 
KY - Cayman Islands 开曼群岛 
CF - Central African Republic 中非 
TD - Chad 乍得 
CL - Chile 智利 
CX - Christmas Island 圣诞岛 
CC - Cocos (Keeling) Islands 可可斯群岛 
CO - Colombia 哥伦比亚 
KM - Comoros 科摩罗 
CG - Congo 刚果 
CD - Congo, Democratic Republic 刚果 
CK - Cook Islands 库克群岛 
CR - Costa Rica 哥斯达黎加 
CI - Cote D'Ivoire (Ivory Coast) 象牙海岸 
HR - Croatia (Hrvatska) 克罗地亚 
CU - Cuba 古巴 
CY - Cyprus 塞普路斯 
CZ - Czech Republic 捷克 
DK - Denmark 丹麦 
DJ - Djibouti 吉布提 
DM - Dominica 多米尼加
TP - East Timor 东帝汶 
EC - Ecuador 厄瓜多尔 
EG - Egypt 埃及 
SV - El Salvador 萨尔瓦多 
GQ - Equatorial Guinea 赤道几内亚 
EE - Estonia 爱沙尼亚 
ET - Ethiopia 埃塞俄比亚 
FK - Falkland Islands (Malvinas) 福兰克群岛 
FO - Faroe Islands 法罗群岛 
FJ - Fiji 斐济 
FI - Finland 芬兰 
FR - France 法国 
GF - French Guiana 法属
GA - Gabon 加蓬 
GM - Gambia 冈比亚 
GE - Georgia 格鲁吉亚 
DE - Germany 德国 
GH - Ghana 加纳 
GI - Gibraltar 直布罗陀 
GB - Great Britain 英国 
GR - Greece 希腊 
GL - Greenland 格陵兰岛 
GD - Grenada 格林纳达 
GP - Guadeloupe 法属德洛普群岛 
GU - Guam 关岛 
GT - Guatemala 危地马拉 
GN - Guinea 几内亚 
GY - Guyana 圭亚那 
HT - Haiti 海地 
HM - Heard and McDonald Islands 赫德 麦克唐纳群岛 
HN - Honduras 洪都拉斯 
HK - Hong Kong 香港
HU - Hungary 匈牙利 
IS - Iceland 冰岛 
IN - India 印度 
ID - Indonesia 印度尼西亚 
IR - Iran 伊朗 
IQ - Iraq 伊拉克 
IE - Ireland 爱尔兰 
IL - Israel 以色列 
IT - Italy 意大利 
JM - Jamaica 牙买加 
JP - Japan 日本 
JO - Jordan 约旦 
KZ - Kazakhstan 哈萨克斯坦 
KE - Kenya 肯尼亚 
KI - Kiribati 基里巴斯 
KP - Korea (North) 韩国 
KR - Korea (South) 朝鲜 
KW - Kuwait 科威特 
KG - Kyrgyzstan 吉尔吉斯斯坦 
LA - Laos 老挝 
LV - Latvia 拉托维亚 
LB - Lebanon 黎巴嫩 
LI - Liechtenstein 列支顿士登 
LR - Liberia 利比里亚 
LY - Libya 利比亚 
LS - Lesotho 莱索托 
LT - Lithuania 立陶宛 
LU - Luxembourg 卢森堡 
MO - Macau 澳门
MG - Madagascar 马达加斯加 
MW - Malawi 马拉维 
MY - Malaysia 马来西亚 
MV - Maldives 马尔代夫 
ML - Mali 马里 
MT - Malta 马耳他 
MH - Marshall Islands 马绍尔群岛 
MR - Mauritania 毛里塔尼亚 
MU - Mauritius 毛里求斯 
MX - Mexico 墨西哥 
FM - Micronesia 米克罗尼西亚 
MC - Monaco 摩纳哥 
MD - Moldova 摩尔多瓦 
MA - Morocco 摩洛哥 
MN - Mongolia 蒙古 
MS - Montserrat 蒙塞拉特岛 
MZ - Mozambique 莫桑比克 
MM - Myanmar 缅甸 
NA - Namibia 纳米比亚 
NR - Nauru 瑙鲁 
NP - Nepal 尼泊尔 
NL - Netherlands 荷兰 
AN - Netherlands Antilles 荷属
NC - New Caledonia 新卡里多尼亚 
NZ - New Zealand (Aotearoa) 新西兰 
NI - Nicaragua 尼加拉瓜 
NE - Niger 尼日尔 
NG - Nigeria 尼日利亚 
NU - Niue 纽爱 
NF - Norfolk Island 诺福克岛 
MP - Northern Mariana Islands 北马里亚纳群岛 
NO - Norway 挪威 
OM - Oman 阿曼 
PK - Pakistan 巴基斯坦 
PW - Palau 帕劳 
PA - Panama 巴拿马 
PG - Papua New Guinea 巴布亚新几内亚 
PY - Paraguay 巴拉圭 
PE - Peru 秘鲁 
PH - Philippines 菲律宾 
PN - Pitcairn 皮特克恩岛 
PL - Poland 波兰 
PT - Portugal 葡萄牙 
PR - Puerto Rico 波多黎各 
QA - Qatar 卡塔尔 
RO - Romania 罗马尼亚 
RU - Russian Federation 俄罗斯 
RW - Rwanda 卢旺达 
KN - Saint Kitts and Nevis 圣基茨和尼维斯 
LC - Saint Lucia 圣卢西亚 
VC - Saint Vincent and the Grenadines 圣文森特和格陵纳丁斯 
WS - Samoa 西萨摩亚 
SM - San Marino 圣马力诺 
ST - Sao Tome and Principe 圣多美和普林西比 
SA - Saudi Arabia 沙特阿拉伯 
SN - Senegal 塞内加尔 
SC - Seychelles 塞舌尔 
SL - Sierra Leone 塞拉利昂 
SG - Singapore 新加坡 
SI - Slovenia 斯罗文尼亚 
SK - Slovak Republic 斯洛伐克 
Sb - Solomon Islands 所罗门群岛 
SO - Somalia 索马里 
ZA - South Africa 南非 
ES - Spain 西班牙 
LK - Sri Lanka 斯里兰卡 
SD - Sudan 苏丹 
SR - Suriname 苏里南 
SZ - Swaziland 斯威士兰 
SE - Sweden 瑞典 
CH - Switzerland 瑞士 
SY - Syria 叙利亚 
TW - Taiwan 台湾
HK - Hangkang 香港
AM - Aomen 澳门
TJ - Tajikistan 塔吉克斯坦 
TZ - Tanzania 坦桑尼亚 
TH - Thailand 泰国 
TG - Togo 多哥 
TK - Tokelau 托克劳群岛 
TO - Tonga 汤加 
TN - Tunisia 突尼斯 
TR - Turkey 土尔其 
TM - Turkmenistan 土库曼斯坦 
TV - Tuvalu 图瓦卢 
UG - Uganda 乌干达 
UA - Ukraine 乌克兰 
AE - United Arab Emirates 阿联酋 
UK - United Kingdom 英国 
US - United States 美国 
UY - Uruguay 乌拉圭 
Ru - Russia 俄罗斯
UZ - Uzbekistan 乌兹别克斯坦 
VU - Vanuatu 瓦努阿鲁 
VA - Vatican City State (Holy See) 梵蒂岗 
VE - Venezuela 委内瑞拉 
VN - Viet Nam 越南 
VG - Virgin Islands (British) 英属维京群岛 维京群岛
EH - Western Sahara 西撒哈拉 
YE - Yemen 也门 
YU - Yugoslavia 南斯拉夫 
ZM - Zambia 赞比亚 
(ZR - Zaire) - See CD Congo, Democratic Republic 扎伊尔 
ZW - Zimbabwe 津巴布韦 